#############################################################################################################
#aujzlq w###,,,################# 1  ########   a      ,,,,  C                            ####################
#ox      ###,######  2 |      |1 D  |             @    ,,      ######################### ###      ###########
#gqi    y###,#####  ############ 1  ########  A        ,,  F   ###r    ###      n  ##### ###   W  ###########
###  #######,####  l #######################     v    ,,,,     ###  I  ### B              #####   ###########
##n    m  ,,,,,  abc pm   ######   ##################%######%#####     ###      C  ###### #   #   ###########
##    @   #####  rde zlkq %%%     B  ################%######%#######-#####   e     ###### # j |   ###########
##i   B   .....  vwf jhu  ###   p                     V                  |         ###### #   #   ###########
#####-######.##### ###########    A  ######-######=#################-#################### #####   ###########
##### #####...#### #############   ######## ####    ################ ########.... fk...##  !      ###########
#####     k        ####      #####-######## ###  F   ####                  ##..........## ###################
#############=#########  s B ##### ######## ##        ###  b   C   k   p   ##..........## ###################
############# #########      ##### ######## ###   c  ####                  ##..........## ###################
#     w       #########=#######   S  ###### ############# #####################..########-###################
#  G   A   B  #####           |      ######               #####################..###            #############
#             #####  ##########   C  ####################         z        ####..####     C    ##############
###-###############  #### l x##      ####################     C      m     #####.....    e     ##############
##        #####        ##  q ##   v  ########  I ######## k                %%%######            #############
##    A   #####  W  B  ##o  w##-####-#######      ##################-########%########### ###################
## k      #####        ###.#### #### ###### c   r  ################# #######   ########## #####,,,,,,,#######
#####-############ #######.#### #### ######   k     ################ #######      ####### #####,, in,,#######
##### ############ #.......####  $     #####      #####               #######  E        ! #####,,,,,,,,######
#####        !     #.##########        ######    ######   D    d      ######      ####### ########,##########
########%###########.######################### ########               ######   ########## !     ##,##########
########  A         .    C      v     ########       |          ######################### ##    ##,##########
########        S   .                 #################   d     #########################S## w  ##,##########
####################.### ##### ########################      ############################ ##    ##,##########
###   i   ######.....###-#####-#####             ######      #####         W     ######## ##  J ##,##########
####     ###     ####### ##### ##### E  ## ## E  ######   k  #####  C                   | ##    ##,##########
####     ###  l  ####            ###    ## ##    ######-##########    #######    ######## ##    ##,##########
####  B  ###     ####            ###    ## ##    ###### ##########    #n f  #    ######## ##    ##,##########
####     ############   D   k    #########%############ ##########    #  R  #    ######## ##    ##,##########
####  B             |            |         V            ##########    #  r  #    ######## !     ##,##########
####     ############            ###############-#################    ###-###    ######## ########,##########
####     #################%##################### #################               ######## ######,,,##########
####  B  #####       #####%######....        ###                     G        C  ######## ######,############
####     #####   c   #####%#####z q..    H   ######################################             ,  ##########
###   o   ####       #####%######....    $$  ######################################  @   F  @   , M #########
# n         #####%########%############-###########################################             ,  ####
#################                                 B       B             ################%#######,######
####       k  ###        A       A                                      ################%#######,######
####  .....   #############################-##########=######=#########-################%#######,######
#### ...a...  ######################             ##### ###### #########                    ##,,,,######
#### ... ...  ####  z ######  z ####     F       ##### ###### #########       ,,,,,,       ##,,,,######
####  .....   ####    ######    ####             #####        #########       ,  d ,  H    ##,  ,######
####          ####  K   ##    K #########-############# b a  ##########       ,,,,,,       ##dyze######
####           ######## ## ############## ############# d c  ##########                    ############
############     !             |          ############# e z  ##########################################
#######################################################################################################
#######################################################################################################
